288,   144,   432,   360,   216,   72,    504,   288,   144,   432
-128,  -128,  -128,  -128,  -128,  -128,  -128,  -256, -256,  -256
0,     0,     0,     0,     0,     0,     0,     0,     0,     0
4,     4,     4,     3,     3,     3,     3,     3,     3,     3
0,     0,     0,     0,     0,     0,     0,     32,    32,    32
16,    16,    16,    32,    32,    32,    32,    32,    32,    32
1500,  1500,  1500,  3000,  3000,  3000,  3000,  2000,  2000,  2000
0,     0,     0,     1,     1,     1,     1,     2,     2,     2
EOF
288,   144,   432,   360,   216,   72,    504,   288,   144,   432
-128,  -128,  -128,  -128,  -128,  -128,  -128,  -256, -256,  -256
0,     0,     0,     0,     0,     0,     0,     0,     0,     0
4,     4,     4,     2,     2,     2,     2,     2,     2,     2
0,     0,     0,     0,     0,     0,     0,     32,    32,    32
16,    16,    16,    32,    32,    32,    32,    32,    32,    32
1500,  1500,  1500,  3000,  3000,  3000,  3000,  2000,  2000,  2000
0,     0,     0,     1,     1,     1,     1,     2,     2,     2
EOF
288,   144,   432,   360,   216,   72,    504,   288,   144,   432
-128,  -128,  -128,  -128,  -128,  -128,  -128,  -256, -256,  -256
0,     0,     0,     0,     0,     0,     0,     0,     0,     0
4,     4,     4,     2,     2,     2,     2,     2,     2,     2
0,     0,     0,     0,     0,     0,     0,     32,    32,    32
16,    16,    16,    32,    32,    32,    32,    32,    32,    32
1500,  1500,  1500,  3000,  3000,  3000,  3000,  2000,  2000,  2000
0,     0,     0,     1,     1,     1,     1,     2,     2,     2
EOF
288,   144,   432,   360,   216,   72,    504,   288,   144,   432
-128,  -128,  -128,  -128,  -128,  -128,  -128,  -256, -256,  -256
0,     0,     0,     0,     0,     0,     0,     0,     0,     0
4,     4,     4,     2,     2,     2,     2,     2,     2,     2
0,     0,     0,     0,     0,     0,     0,     32,    32,    32
16,    16,    16,    32,    32,    32,    32,    32,    32,    32
1500,  1500,  1500,  3000,  3000,  3000,  3000,  2000,  2000,  2000
0,     0,     0,     1,     1,     1,     1,     2,     2,     2
EOF
288,   144,   432,   360,   216,   72,    504,   288,   144,   432
-128,  -128,  -128,  -128,  -128,  -128,  -128,  -256, -256,  -256
0,     0,     0,     0,     0,     0,     0,     0,     0,     0
4,     4,     4,     2,     2,     2,     2,     2,     2,     2
0,     0,     0,     0,     0,     0,     0,     32,    32,    32
16,    16,    16,    32,    32,    32,    32,    32,    32,    32
1500,  1500,  1500,  3000,  3000,  3000,  3000,  2000,  2000,  2000
0,     0,     0,     1,     1,     1,     1,     2,     2,     2
EOF